R 1500 750

SO ./textures/wood_hi.xpm
EA    ./textures/stone_hi.xpm
WE ./textures/metal_hi.xpm
NO       ./textures/brick_hi.xpm
S ./textures/star.xpm

C = 35,15,88
F = 200,100,100

11111111
 111001111111111111111111
 110000000000000000000000111                1 1 1 1
 1001000111111111111111011           111111101
 1001011 111          101 1111111111111100000111
11N111111111111111111110110000000000000000001
100000001 1000000000000001100100111001111111
10000000010000111111111110000111111111111111
1000000000000001         111111
111111111110111
1000000000000001
1020000000000001
100000020000000111111111111111111111111111111111111111111111111111111111111111111111111111111111
102002000002000000000000000000000000000000000000000000000000000000000000000000000000000000021
10000002000000011111111111111111111111111111111111111111111111111111111111111111111111111111111111111111111111111
100000000000000111111
1111111000000000000001
    11000000000111111
1111200000000001
111111111111111111